***********
*$       $*
***   *****
*      *  *
*    $ *  *
*****  *  *
*  $      *
*  *     $*
*  * ******
*  * *@   *
*$        *
***********
