***********
*         *
*         *
*         *
*    $    *
*****     *
*         *
*         *
*    ******
*    *@   *
*         *
***********
