***********
*$$$$$$$$$*
*$$$$$$$$$*
*$$$$$$$$$*
*$$$$$$$$$*
*****$$$$$*
*$$$$$$$$$*
*$$$$$$$$$*
*$$$$******
*$$$$*@$$$*
*$$$$$$$$$*
***********
